5 7
1 2
0 0 0 0 0
0 0 1 2 0
0 0 3 1 0
0 3 3 4 0
0 3 3 3 3
0 0 3 3 0
0 0 0 0 0